語彙 (goi) - vocabulary.
僕 (boku) - i, me.
初 (hatsu) - first time. Noun which may take the genitive case particle 'no', Noun, Noun, used as a prefix, Noun, used as a suffix
映画(eiga) - movie.
優(yasa.shii) - tenderness, gentleness, actor.
女優(jyoyuu)- actress.
台風(taifuu)- typhoon.
台(utena)-pedestal
風(kaze)- wind, style, manner.
好(kono, ii) - fond, like something(maybe ask??)
何(nani) - what.
感(kan.ji)- emotion, feeling, sensation.
薬屋(kusuri ya)- pharmacist.
洋画(yo ga) - Western film.
観(miru) - look, appearance.
字幕(jimaku) - subtitles.
字(aza) - character, letter, word.
幕(tobani) - curtain, bunting.
読(yomu) - read.
不思議(fushigi) - wonderful, marvelous.
議(gi) - deliberation.
思(omo.u)- think.
不(fu)- negative
文字(moji)- letter(of an alphabet), character.
文(fumi)-sentence, literature, style.
夜(yoru)- night, evening
選(erabu)- elect, choose, prefer.
魚(sakana)- fish.і
3.09.2025
同(ona.ji)- the same.
劇(geki) - drama, play.
日(hi) - day(first reading)
日曜(nichiyou) - sunday.
日劇(nichigeki)- japanese drama.
話(hanashi) - talk, chat.
浜辺(hamabe) - beack, foreshore.
浜 (hama) - seacoast, beach, seashore.
辺 (atari) - environs boundary, boundary.(don't add anki ask first). 
最低(saitei) - worst, lowest, least.
5.09.2025
見(mi.ru) - see, hopes, chances, idea
意見(iken) - opinion, view, comment.
意(i) - idea, mind, heart, taste.
面白(omoshiro) - amusing, funny, interesting.
通信(tsuishin) - correspondence, communication.
通(too.ru) - traffic, pass through, avenue.
信(shin) - faith, truth, trust, fidelity.
始め(hajime)- beginning, start.
始(haji) - commence, begin.
慣れる(nareru) - to get used to, accustumed to.
事(koto) - thing, matter.
多(ooi) - many, much, frequent.
勝(katta) - selfishness, 
手(te) - hand.
勝(katsu)- victory, win, prevail, excel.
言(gen) - word, say.
嫌(kirai) - dislike, detest, hate.
我慢(gaman) - endurance, patience, perseverance
我(ware) - ego, I, selfish, oneself.
慢(man) - ridicule, laziness.
合(a.u) - fit, suit, join (also stick together but???).
黄昏(tasogare) - dusk, twilight.
方(kata) - direction, way, side.
良(yoi) - good, pleasing, skilled.
11.09.2025
学校 (gakkou) - school.
学 (gaku) - study, learning, science.
校 (kou) - school, exam, correction.
学生 (gakusei) - student.
生 (sei) - life, birth, living, raw.
先生 (sensei) - teacher, master.
先 (sen) - previous, ahead, future, priority.
友達 (tomodachi) - friend.
時間 (jikan) - time, hour.
時 (toki) - time, hour, occasion.
間 (aida) - interval, space, between.
水 (mizu) - water.
食べる (taberu) - to eat.
食 (shoku, ta) - eat, food.
飲む (nomu) - to drink.
行く (iku) - to go.
行 (kou, gyou, i.ku) - go, conduct, line, journey.
来る (kuru) - to come.
魔女(majo) - witch.
木枯らし(kogarashi) - withered tree wind.
変(hen) - strange, odd, peculiar, weird.
枯れる(kareru) - wither(of a plant), to be blasted, to die.
15.09.2025
色々(iroiro) - various, all sorts of.
色(iro) - color.
考える(kangaeru) - to thnk(about of), to ponder, to contemplate, to reflect.
勉強(benkyou) - to study.
顔(kao) - face.
分かる(wakaru) - to understand to comprehend.
気(ki) - spirit, mind, air.
楽(raku) - comfort, ease, relief.
題名(daimei) - title, caption.
励み(hagemi) - encoragement.
未来(mirai) - (distant) future.
将来 (shourai) - future(more short), future prospects. 
百景(hyakkei) - 100 sceneries.
百(hyaku) - 100 as a number.
景(kei) - scenery, view.
贈り物(okurimono) - present, gift.
空中(kuuchuu) - sky, air, mid-air.
前(mae) - last (i.e. immediately preceding); previous;
疑問(gimon) - doubt, question, suspicion.
会話(kaiwa) - conversation, talk, chat.
出(deru) - exit, leave, go out
出て来る(detekuru) - to come out, to appear, to turn up.
物(mono) - thing, object, matter.
途中(tochyuu) - on the way, en route.
時々(tokidoki) - sometimes, occasionally, at times.
誰(dare) - who.
最近(saikin) - recently, lately, these days.
雲(gumo) - cloud.
19.09.2025
揺(yu.reru) - swing shake, sway , rock.
揺らぎ(yuragi) - quiver, flutter.
蟻(ari) - ant.
油虫(aburamushi) - aphid, plant louse.
新(shin) - new, neo-.
新しい(atarashi) - new, novel, fresh.
猫(neko) - cat.
忘(wasu) - forget.
忘れ物(wasuremono) - lost article, thing left behind.
荷物(nimotsu) - luggage, baggage, package.
荷(ni) - baggage. 
詞(kotoba) - words, poetry.
台詞(serifu) - comment, remark, phrase.
駄目(dame) - no good, useless.
目(me) - eye, class, insight.
落(ochi) - slip, omission.
落ちる(ochiru) - fall, drop, come down.
落とす(otosu) - to drop, to lose, to let fall.
花瓶(kabin) - flower(vase).
曲(kyouku) - composition, piece of music.
最後(saigo) - end, conclusion.
少し(sukoshi) - a little bit, a small amount.
兄弟(kyoudai) - siblings, brothers and sisters.
泣く(naku) - to cry, to shed tears, to weep.
7.10.2025
誘惑(yuuwaku) - temptation, allurement, lure, encitement.
街(machi) - town, boulevard, rue(mostly in a urban context).
町(machi) - town, block, downtown(mostly in rural context).
詩(uta) - poem, verse, poetry.
歌(uta) - song, singing.
神(kami) - god, deity, divinity, spirit.
教室(kyoushitsu) - classroom, lecture room.
教える(oshieru) -teach, faith, doctrine 
宗教(shoukyou) - religion, religious affiliation, belief, faith, creed.
伝説(densetsu) - legend, folklore, tradition.
部分(bubun) - portion, section, part.
後ろ(uhshiro) - back, behind, rear.
眠る(nemuru) - to sleep.
歩く(aruku) - to walk.
恋しい(koishii) - yearned for, longed for, missed.
恋(koi) - (romantic) love, romance.
愛(ai) - love, affection, care.
巨乳(kyonyuu) - huge breasts, huge boobs.
追う(ou) - to chase, to run after, to pursue.
昔(mukashi) - the old days, the past, former times.
変わる(kawaru) - to change.
親切(shinsetsu) - kind, gentle, considerate.
田舎(inaka) - rural area, countryside.
育つ(sodatsu) - to be raised, to grow.
週末(shuumatsu) - weekend.
買い物(kaimono) - shopping
買う(kau) - to buy, purchase.
行く(iku) - to go, to move(towards somehting), to head(towards something).
南瓜(kabochya) - pumpkin.
16.10.2025
大雨(ooame) - heavy rain.
家(ie) - house; residence; dwelling; home
壊れる(kowareru) - to be broken; to break; to fall apart; to collapse; to be destroyed; to be damaged.
先週(senshyuu) - last week.
給料(kyuuryou) - salary, wages, pay;
今(ima) - now, the present time.
上(ue) - above, over, up.
調べる(shiraberu) - to examine, to look up, to investigate.
調子(chyoushi) - tune, tone, key.
16.10.2025
黒(kuro)- black.
船(fune)- ship
将棋(shogi) - shogi; Japanese chess.
会館(kaikan) - meeting hall, assembly hall.
お土産(omiyage) - local specialty or souvenir bought as a gift while traveling (travelling).
桐(kiri) - paulownia, empress tree, foxglove tree.
暁(akatsuki) - 
冬(fuyu) - winter
太陽(taiyou) - Sun.
照明(shoumei) - Lighting, illumination.
照らす(terasu) - to shine on, to illuminate.
真(ma) - true, reality, Buddhist sect.
誠(makoto) - truth, reality, fact.
平常心(heijoyoushin) - normalcy(not for anki).
福神漬(fukujindzuke) - sliced vegetables pickled in soy sauce.
無い(nai)- nonexistent, not being there.
お願い(onegai) - request, favor(to ask), wish;
卵(玉子)(tamago) - eggs, egg.
孤独(kodoku) - solitude, loneliness, isolation.
侘び寂び(wabisabi) - wabi-sabi; aesthetic sense in Japanese art centered on the acceptance of transience and imperfection.Uses kanji proud, lonely(wabi), mellow, mature, death of a priest(sabi).
空(sora) - sky, the air, the heavens.
赤(aka) - red, crimson, scarlet.
染まる(somaru) - to be dyed.
成功(seikou) - success, achievement.
励ます(hagemasu) - to encourage, to cheer on,to cheer someone up.
挑戦(chousen) - challenge, defiance, dare, attempt, try.
証拠(shokou) - evidence, proof.
簡単(kantan) - easy, simple, uncomplicated.
積極的(sekigyouteki) - positive; assertive; active; proactive; aggressive.
彼女(kanojo) - she,her,girlfriend.
気味悪い(kimochiwarui) - unpleasant; uncomfortable; creepy; spooky.
大変(taihen) - very; greatly; terribly; awfully.
情けない(nasakenai) - miserable, pitiable, shameful, deplorable,pathetic.
親友(shinyuu) - close friend; bosom friend; buddy; crony; chum.
菓子(kashi) - confectionery; sweets; candy; cake, pastrie.
古い(furui) - old; aged; ancient; antiquated; antique; timeworn.
家(ie) - house, residence,dwelling, home.
懐かし(natsukashi) - dear (old); good old; longed-for; classic; nostalgic.
十分(jyuubun) - enough,sufficient, plenty.
涼しい(suzushii) - cool, refreshing.
唐揚げ(karaage) -deep-frying food lightly coated in flour or potato starch; deep-fried food (esp. chicken). (i guess not for anki).
稲妻(inazuma) - lightning; flash of lightning; lightning bolt.
24.10.2003(happy birthday weird computer guy).
申し訳ない(moshiwakenai) - I'm sorry; (it's) inexcusable; I feel regretful; I feel guilty.
28.10.2025
友人(yuujin) - another synonym of a word friend, this time in a friend from the office, work.
彼(kare) - he, him.
頼む(tanomu) - to request, to ask, to beg))).
聞く(kiku) - to hear, to listen. 
正直(shojiki) - honest, frank, candid.
味(aji) - taste, flavour, flavor.
終わり(owari) - end, ending, close, conclusion.
紹介(shoukai) - introduction, presentation.
機嫌(kigen) - humor, temper, mood.
悪い(warui) - bad, poor, undesirable.
帰る(kaeru) - to return, to come home, to go home.
今日(kyou) - today, this day.
閉店(heiten) - closing up shop.
時代(jidai) - period, epoch, era.
再会(saikai) - meeting again, reunion.
会社(kaisha) - company, corporation, firm.
激しい(hageshii) - violent; furious; tempestuous.
痛み(itami) - pain, ache, soreness, grief, distress.
知らず(shirazu) - not having; unaffected by.
知識(chishiki) - knowledge, information.
孤立(koritsu) - isolation, being alone, being friendless.
人生(jinsei) - (one's) life.
転機(tanki) - turning point(not for anki).
気分(kibun) - feeling, mood.
質問(shitsumon) - question; inquiry; enquire.
現在(genzai) - the present, present time, now.
3.11.2025
子供(kodomo) - child, children.
大事(daiji) - important, serious, crucial.
風(second meaning)(fuu) - manner; behaviour; behavior.
感覚(kankaku) - sense; sensation; feeling; intuition.
服(fuku) - clothes (esp. Western clothes); clothing; dress; costume; suit; outfit.
洋服(yofuku) - Western-style clothes (cf. traditional Japanese clothes).
蝉(semi) - cicada, locust.
鳴き声(nakigoe) - cry (of an animal), call, chirp, song, caw.
都会(tokai) - city.
天気(tenki) - weather.
外(soto) - outside.
悲しい(kanashii) - sad, miserable, unhappy, sorrowful.
落書き(rakugaki) - scrawl; scribble; graffiti; doodle.
結構(kekkou) - splendid; nice; wonderful; delightful; lovely; excellent; fine.
多分(tabun) - probably; likely; perhaps; maybe.
連れる(tsureru) - to take (someone) with one; to bring along; to go with; to be accompanied by.
難しい(mizukashii)  - difficult; hard; troublesome; complicated; serious (disease, problem, etc.).
有難う(arigatou) - thank you, thanks.
辛い(tsurai) - painful; bitter; heart-breaking; difficult (emotionally).
遠い(tooi) - far; distant; far away; a long way off; in the distance.

雷(kaminari) -  lightning; thunder; thunderbolt.
魂(tamashii) - soul, spirit, mind.
細い(hosoi) - thin, slender, fine.
腕(ude) - arm.
眩しい(mabushii) - dazzling; radiant.
悔しい(kuyashii) - frustrated (over a failure, humiliation or injustice); annoyed; chagrined; (bitterly) disappointed; bitter; vexed; frustrating; annoying; regrettable​
存在(sonzai) - existence; being; presence.
機織り虫(wataorimushi) - grasshopper.
飛蝗(batta) - grasshopper.
辛さ(tsurasa) - pain; bitterness.
蜂(hachi) - bee; wasp; hornet.
蝶(chou) - butterfly.
望み(nozomi) - wish; desire; hope.
幸せ(shiawase) - happiness good fortune; luck; blessing.
葬式(soushiki) - funeral. 
組織(soshiki) - organization; organisation; formation.
16.11.2025
死(shi) - death.
書(kaku) - write.
書斎(shasai) - study; library; den; home office; reading room.
供給(kyoukyuu) - supply, provision. 
動物(doubutsu) - animal.
嵐(arashi) - storm; tempest.
書庫(shoko) - library; book storage; stack room.
泥棒(dorobo) - thief; burglar; robber.
戦い(tatakai) - battle; war; fight; conflict.
風花(kazabana) - flurry of snow in a clear sky.
暗殺者(asashin) - asassin.
力(chikara) - force; strength; might; vigour; vigor; energy.
事実(jijitsu) - fact; truth; reality.
見殺し(migoroshi) - letting (someone) die without helping.
急ぐ(isogu) - to hurry; to rush; to hasten; to make something happen sooner.
冷たい(tsumetai) - cold (to the touch); chilly; icy; freezing. (emotionally) cold; coldhearted; unfeeling; indifferent; unfriendly; distant.
人間(ningen) - human being; human; person; man; mankind; humankind.
人類(jinrui) - mankind; humanity.
見捨てる(misuteru) - to abandon; to fail; to desert; to forsake.
理由(riyuu) - reason; grounds; pretext; excuse; motive.
燃える(moeru) - to burn; to get fired up.
交換(koukan) - exchange; interchange; switching; reciprocity; barter; substitution; replacement; clearing (of checks, cheques).
火事(kaji) - fire; conflagration.
頼る(tayoru) - to rely on; to depend on; to count on; to turn to (for help).
誘拐(yuukai) - abduction; kidnapping; kidnaping.
弱い(yowai) -weak; frail; delicate; tender; unskilled; weak (wine).
出口(deguchi) - exit; way out.
瞬間(shunkan) - moment; instant; second.
28.11.2025
視聴者(schicho-sha) - viewer; (television) audience.
予想 (yosou) - expectation; anticipation; prediction; forecast; conjecture.
状況 (jyoukyou) - state of affairs; situation; conditions; circumstances.
意外(igai) - unexpected; surprising.
業界(gyoukai) - buisness world(not work anki) 
似る(niru) - to resemble; to look like; to be like; to be alike; to be similar; to take after.
詰らない(tsumaranai) - dull, uninteresting, boring.
吹く(fuku) - to blow (of the wind),to blow (one's breath); to breathe out.
昨日(kinou) - yesterday.
強い(tsuyoi) - strong; potent; competent; domineering; tough.
打つ(utsu) - to hit; to strike; to knock; to beat; to punch; to slap; to tap; to bang; to clap; to pound.
思考(shikou) - thought; consideration; thinking.
深い(fukai) - deep.
深夜(shinya) - late at night, midnight (aka. deep night).
川(kawa) - river; stream.
心当たり(kokoroatari) - having in mind; happening to know (of); idea (of); inkling.
助手(dzyoshyu) -assistant; helper.
社会(shakai) - society. 
資本主義(shigonshugi) - capitalism.
給与(kyuuyo) - pay; salary; wages.
練習(renshuu) - practice; training; drill; (an) exercise; workout.
殺伐(satsubatsu) - brutal (atmosphere, society, etc.); savage; fierce; violent; bloodthirsty; stark.
社内恋愛(shanaireai) - office romance; office love affair.
特別(tokubetsu) - special; particular; extraordinary; exceptional; especial.
噂(uwasa) - rumour; rumor; report; hearsay; gossip; common talk.
大切(taisetsu) - important; significant; serious; crucial.
数日後(suujitsugo) - several days later.
後半(kouban) - second half; latter half.
前半(zenban) - first half.
秘密(himitsu) - secret; secrecy; confidentiality; privacy.
路面電車(romendensha) - tram streetcar; trolley; tramcar.
戦後(sengo) - postwar period.
戦争(sensou) - war.
猿(saru) - monkey (esp. the Japanese macaque, Macaca fuscata); ape; non-human primate.
小説(shousetsu) - novel; story; (work of) fiction.
不愉快(fuyukai) - unpleasant; disagreeable; displeasing; uncomfortable; unhappy.
作り(tsukuri) - making; producing; manufacturing; building; construction; make; structure.
老人(roujin) - old person; senior citizen; the aged; the elderly.
お菜(okazu) - small dish (usu. one of several accompanying rice); side dish.
最果て(saihate) - the farthest ends; the furthest ends(like 最後 in poesy).
位置付け(ichidzuke) - placement; fixed position; mapping out; location.
抜ける(nukeru) - to come out; to fall out; to be omitted; to be missing; to escape; to come loose.
為(tame) - good; advantage; benefit; welfare.
意識(ishiki) - consciousness.
海辺(umibe) - beach; seashore; seaside; coast.
謳う(utau) - to extol; to sing the praises of; to celebrate.
自意識(jishiki) - self-consciousness.
暗い(kurai) - dark; gloomy; murky.
晴れる(hareru) - to clear up; to clear away; to be sunny; to stop raining.
祈る(inoru) - to pray; to say a prayer; to say grace.
響く(hibiku) - to resound; to be heard far away.
住む(sumu) - to live (of humans); to reside; to inhabit; to dwell; to abide.
散歩(sanpo) - walk; stroll.
若い(wakai) - young; youthful.
自分(jibun) - myself; yourself; oneself; himself; herself.
不便(fuben) - inconvenience; inexpediency; unhandiness.
便利(benri) - convenient; handy; useful.
全く(mattaku) - really; truly; entirely; completely; wholly; perfectly.
問題(mondai) - question (e.g. on a test); problem.
例えば(tatoeba) - for example; for instance; e.g.
次(tsugi) - next; following; subsequent.
必ず(kanarazu) - always; without exception; necessarily; certainly; without fail; positively; invariably.
家賃(yachin) - rent.
27.01.2026

全然(zenzen) - (not) at all; (not) in the slightest.
安い(yasui) - cheap; inexpensive.
自然(shizen) - nature.
全体的(zentaiteki) - overall; general; as a whole.
穏やか(odayaka) - calm; quiet; gentle; peaceful; mild.
個人的(gojinteki) - personal; individual; private.
居酒屋(izakaya) - izakaya; tavern, bar, etc. that also serves various dishes and snacks.
遊び(asobi) - play; playing; game.
お隣さん (otonari-san) - (next-door) neighbour; neighbor.
近所(kinjo) -neighbourhood; neighborhood; vicinity.
世間話(sekenbanashi) - small talk, chat, gossip.
苦手(nigate) - poor (at something); weak (in something); not very good (at)
絶対(zettai) - absolutely; definitely; unconditionally.
入る(hairu) - to enter; to come in; to go in; to get in; to arrive.
仲良く(nakayoku) - on good terms (with); on friendly terms (with); (getting along) well; in harmony; happily; peacefully.
世界(sekai) - the world; society; the universe.
生活(seikatsu) - life; living.
休み(yasumi) - rest; recess; respite.
翼(tsubasa) - wing.
動画(douga) - video (esp. digital); video clip; clip.
楽しい(tanoshi) - enjoyable; fun; pleasant; happy; delightful.
08.02.2026

送る(okuru) - to send; to dispatch; to forward; to transmit; to ship; to remit.
海外(kaigai) - foreign; abroad; overseas.
人気(ninki) -popularity; public favor, popular.
一般(ippan) - general; universal.
性格(seikaku) - character (of a person); personality; disposition; nature.
違う(chigau) - to differ (from); to be different; to be distinct; to be unlike; to vary; to disagree (with).
個人(koujin) - individual; private person; personal; private.
本当(hontou) - truth; reality; actuality; fact.
観光客(kankoukyaku) - tourist.
観光(kankou) - sightseeing; tourism.
移住(ijyuu) - migration; move; emigration; immigration.
増える(fueru) - to increase; to multiply.
寂しい(sabishii) - lonely; lonesome; solitary; desolate.
青い(aoi) - blue, azure;
知る(shiru) - to know; to be aware (of); to be conscious (of); to learn (of); to find out; to discover
避難(binan) - taking refuge; finding shelter; evacuation; escape; seeking safe haven.
今月(kongetsu) - this month.
起こる(okoru) - to occur; to happen.
地震(jishin) - earthquake.
注意(chyui) - attention; notice; heed.
情報(jouhou) - information; news; report; intelligence.
悪(aku) - evil; wickedness.
今夜(konya) - this evening; tonight.
会議(kaigi) - meeting; conference; session; assembly; council; convention; congress.
知り合い(shiriai) - acquaintance.
次(tsugi) - next; following; subsequent.
成る程(naruhodo) - I see; that's right; indeed.
団地(danchi) - multi-unit apartments; apartment complex.
教育(kyoiku) - education; schooling; training; instruction; teaching; upbringing.
人々(hitobito) - people; men and women.
要塞(yosai) - fort; stronghold; fortification.
巨大(kyodai) - huge; gigantic; enormous.	
強大(kyoudai) - mighty; powerful.
神獣(shinjyuu) - divine beast(probably not for anki right now)
地上(chijyou) - above ground; on the ground; earth's surface.
炎(honou) - flame; blaze.
失う(ushinau) - to lose.
聖剣(seiken) - holy sword.
勇者(yuusha) - hero; the brave; man of valour (valor).
平和(heiwa) - peace; harmony.
流れ(nagare) - flow (of a fluid or gas), stream, current
歴史(rekishi) -
